11111111111111111111111111111111111
1P000000000000000000000000000000001
10001000000000000000000000000000001
11011000000000000000000000000000001
100010000000000000000000C00000C0001
10E010000000000000000001C1000000011
11111111111111111111111111111111111